{
  "stages" : [
    {
      "levelName" : "tutorial",
      "field":
      [
        [0,0,0,0,0,0,0,0],
        [0,0,0,0,0,0,0,0],
        [0,1,1,1,1,1,1,0],
        [0,2,3,4,4,4,5,0],
        [0,0,0,0,0,0,0,0],
        [0,0,0,0,0,0,0,0],
        [0,0,0,0,0,0,0,0],
        [1,1,1,1,1,1,1,1]
      ]
    },
    {
      "levelName" : "SQUARE",
      "field":
      [
        [0,0,0,0,0,0,0,0],
        [0,0,0,1,1,1,1,0],
        [0,0,0,4,4,4,4,0],
        [0,0,0,4,0,0,4,0],
        [0,1,1,4,1,1,4,0],
        [0,2,3,4,4,4,4,0],
        [0,0,0,5,0,0,0,0],
        [0,0,0,0,0,0,0,0]
      ]
    },
    {
      "levelName" : "PLATFORM",
      "field":
      [
        [0,0,4,1,1,0,0,0],
        [0,4,4,4,4,0,0,0],
        [0,0,3,1,4,1,0,0],
        [1,0,4,4,3,4,0,0],
        [4,1,4,0,4,0,0,0],
        [4,4,3,4,0,0,0,0],
        [3,0,4,1,0,0,0,0],
        [2,4,4,5,0,0,0,0]
      ]
    },
    {
      "levelName" : "3",
      "field":
      [
        [0,0,0,0,0,0,0,0],
        [0,0,0,0,0,0,0,0],
        [0,0,0,0,0,0,0,0],
        [0,0,0,0,0,0,0,0],
        [0,0,0,0,0,0,0,0],
        [0,0,0,0,0,0,0,0],
        [0,0,0,0,0,0,0,0],
        [0,0,0,0,0,0,0,0]
      ]
    },
    {
      "levelName" : "4",
      "field":
      [
        [0,0,0,0,0,0,0,0],
        [0,0,0,0,0,0,0,0],
        [0,0,0,0,0,0,0,0],
        [0,0,0,0,0,0,0,0],
        [0,0,0,0,0,0,0,0],
        [0,0,0,0,0,0,0,0],
        [0,0,0,0,0,0,0,0],
        [0,0,0,0,0,0,0,0]
      ]
    }
  ]
}